111111111111111111111
110110001100011000111
110111101111011110111
110110000000011100011
110111101111011110111
110000001100000000111
111111111111111111111