1111111111111
1E0P000000001
10000000000C1
1000000000001
1111111111111