111111111111111111111111111
1000000000000C00000000000E1
1111000C0111111111111111111
111111100000001000000000001
111111111110001000010000001
100x00000000001000010000001
111111100000000000010000001
100000111111100000010000001
101110100000111111110000001
1P100C000100000000000000001
111111111111111111111111111