1111111111111
100000000C001
1011111x00001
1E1P000000001
1111111111111