1111111111111
1000E10000001
10000100C0001
100001P000001
1111111111111