1111111111111
1000E00000001
10000000C0001
100000P000001
111111111111