1111111111111111111111111111
1000011000110111100011011011
1011111010110111101011011011
1000011000110111100011000011
1111011010110111101011011011
1000011010110001101011011011
1111111111111111111111111111