1111111111111
1000E00000001
10000000C0001
10X000P000001
1111111111111